{
    "width": 8,
    "tiles": [
        "#", "&", "#", "#", "&", "#", "#", "#",
        "#", " ", " ", "%", " ", " ", " ", "#",
        "#", "~", " ", "&", "~", " ", " ", "&",
        "%", " ", " ", " ", " ", " ", "~", "&",
        "#", "~", " ", "#", "#", "#", " ", "#",
        "#", " ", "~", "%", " ", " ", " ", "#",
        "#", " ", " ", "#", " ", "~", "~", "#",
        "#", "&", "&", "#", "#", "&", "#", "#"
    ],
    "things": [
        " ", " ", " ", " ", " ", " ", " ", " ",
        " ", " ", "*", " ", " ", " ", "*", " ",
        " ", " ", " ", " ", " ", " ", " ", " ",
        " ", " ", " ", " ", " ", " ", " ", " ",
        " ", " ", " ", " ", " ", " ", " ", " ",
        " ", " ", "*", " ", " ", " ", " ", " ",
        " ", " ", " ", " ", "@", " ", "*", " ",
        " ", " ", " ", " ", " ", " ", " ", " "
    ]
}
