{
    "width": 14,
    "tiles": [
        "#", "#", "#", "#", "#", "#", "#", "#", "#", "#", "#", "#", "#", "#",
        "#", " ", " ", " ", " ", " ", " ", " ", " ", " ", " ", " ", " ", "#",
        "#", " ", "#", "&", "#", " ", "&", "#", "#", "#", " ", " ", " ", "#",
        "#", " ", "#", " ", " ", "%", " ", " ", " ", " ", "#", " ", " ", "#",
        "#", " ", "#", "~", " ", "&", "~", " ", " ", "&", " ", " ", " ", "#",
        "#", " ", "%", " ", " ", " ", " ", " ", "~", "&", " ", " ", " ", "#",
        "#", " ", "#", "~", " ", "#", " ", "#", " ", "#", " ", "#", " ", "#",
        "#", " ", "#", " ", "~", "%", " ", " ", " ", "#", " ", "#", " ", "#",
        "#", " ", "#", " ", " ", "#", " ", "~", "~", " ", " ", " ", " ", "#",
        "#", " ", "#", " ", "&", "#", " ", " ", " ", "#", " ", " ", " ", "#",
        "#", " ", " ", "&", " ", " ", "#", "&", "#", " ", "#", "#", " ", "#",
        "#", " ", " ", " ", " ", " ", " ", " ", " ", " ", " ", " ", " ", "#",
        "#", " ", " ", " ", " ", " ", " ", " ", " ", " ", " ", " ", " ", "#",
        "#", "#", "#", "#", "#", "#", "#", "#", "#", "#", "#", "#", "#", "#"
    ],
    "things": [
        " ", " ", " ", " ", " ", " ", " ", " ", " ", " ", " ", " ", " ", " ",
        " ", " ", " ", " ", " ", " ", " ", " ", " ", " ", " ", " ", " ", " ",
        " ", " ", " ", " ", " ", " ", " ", " ", " ", " ", " ", " ", " ", " ",
        " ", " ", " ", "*", " ", " ", " ", "*", " ", " ", " ", " ", " ", " ",
        " ", " ", " ", " ", " ", " ", " ", " ", " ", " ", " ", " ", " ", " ",
        " ", " ", " ", " ", " ", "|", " ", " ", " ", " ", " ", " ", " ", " ",
        " ", " ", " ", " ", " ", " ", " ", " ", " ", " ", " ", " ", " ", " ",
        " ", " ", " ", "*", " ", "<", " ", " ", " ", " ", " ", " ", " ", " ",
        " ", " ", " ", " ", " ", " ", "@", " ", " ", "|", " ", " ", " ", "l",
        " ", " ", " ", " ", " ", " ", " ", " ", " ", " ", " ", " ", " ", " ",
        " ", " ", " ", " ", " ", " ", " ", " ", " ", " ", " ", " ", " ", " ",
        " ", " ", " ", " ", " ", " ", " ", " ", " ", " ", " ", " ", " ", " ",
        " ", " ", " ", " ", " ", " ", " ", " ", " ", " ", " ", " ", " ", " ",
        " ", " ", " ", " ", " ", " ", " ", " ", " ", " ", " ", " ", " ", " "
    ]
}
